############B#  #
#            ## #
# ############# #
# #########     #
# ##   #### #####
# #### #### #####
#               #
#A######### ### #